++++++++++
+A      E+
+   E    +
+        +
+       C+
+  C     +
+      E +
+        +
+ E     C+
++++++++++