++++++++++
+A       +
+        +
+        +
+        +
+        +
+        +
+        +
+       C+
++++++++++