++++++++++
+A       +
+     ++++
+      EE+
+++     C+
+  C    E+
+    E +++
+        +
+       C+
++++++++++