++++++++++
+A       +
+     ++++
+        +
+++     C+
+  C     +
+      +++
+        +
+       C+
++++++++++